NO ./path_to_the_north_texture
SO ./path_to_the_south_texture
WE ./path_to_the_west_texture
EA ./path_to_the_east_texture

F 117,141,79
C 139,180,204

11111111111111111111111111111111111111111111111111111111111111111111111111111111
10000000000000000000100000000000000000000000000000000000000000000000000000000001
10000000011000000000100000000000000000000000000000000000000000000000000000000001
10000000110000000001000000000000000000000000100000000000000000000000000000000001
11111111111011111111100000000000001000000000010000000000000000000000000000000111
10000000000000000000100000000000001000000000010000000000000000000000000000001
10000000000000000000100000000000001000000000010000000000000000000000000000000111
10000000000000000000100000000000001000000000010000000000000000000000000000000001
10000000000000000000100000000000001000000000010000000000000000000000000000000001
10000000000000000000100000000000001000000000010000000000000000000000000000000001
10000000000000000000100000000000001000000000010000000000000000000000000000000001
10000000000000000000100000000000001000000000000000000000000000000000000000000001
10000000000000000000111111111111111000000000000000000000000000000000000000000001
10000000000000000000000000000000000000000000000000000000000000000000000000000001
10000000000000000000000000000000000000000000000000000000000010000000000000000001
10000000000000000000000000000000000000000000000000000000000000000000000000000001
10000000000000000000000000000000000000000000000000000000000000000000000000000001
10000000000000000000000000000000000000000000000000000000000100000000000000000001
10000000000000000000000000000000000000000000000000000000000000000000000000000001
10000000000000000000000000000000000000000000000001000000000000000000000000000001
10000000000000011111111110011111111100000000000000000000000000000000000000000001
10000000000000010000000000000000000100000000000000000100000000000000000000000001
10000000000000010100000111110000000100000000000000000000000000000000000000000001
100000000000000100000001   10001000100000000000000000000000000000000000000000001
100000000000000101000001   10000N00100000000000000000100000000000000000000000001
10000000000000010000000111110000000100000000000000001110000000000000000000000001
10000000000000010000000000100000000100000000000000000100000000000000000000000001
10000000000000011111111111111111111100000000000000000000000000000000000000000001
10000000010111110000000000000000000000000000000000000000000000000000000000000001
10000000010000000000000000000000000000000000000000000000000000000000000000000001
10000000010000000000000000000000000000000000000000000000000000000000000000000001
10000000010000000000000000000000000000000000000000000000000000000000000000000001
10000000010000000000000000000000000000000000000000000000000000000000000000000001
10000000010000000000000000000000000000000000000000000000000000000000000000000001
10000000010000000000000000000000000000000000000000000000000000000000000000000001
10000000010000000000000000000000000000000000000000000000000000000000000000000001
11111111111111111111111111111111111111111111111111111111111111111111111111111111