NO ./path_to_the_north_texture
SO ./path_to_the_south_texture
WE ./path_to_the_west_texture
EA ./path_to_the_east_texture

F 117,141,79
C 139,180,204

11111
10101
10N01
10001
11111
