NO ./textures/purplestone.xpm
SO ./textures/mossy.xpm
WE ./textures/redbrick.xpm
EA ./textures/wood.xpm

F 80,141,79
C 90,180,204

11111111
10000011
10000001
10000N01
11111111