NO ./pics/purplestone.xpm
SO ./pics/redbrick.xpm
WE ./pics/redbrick.xpm
EA ./pics/redbrick.xpm

F 117,141,79
C 139,180,204

11111111
10000011
10000001
10000E01
11111111